X X X X X X X X X X X
X O _ _ _ X X X X X X
X _ X X _ X X X X X X
X _ _ B B X X X X X X
X X _ X _ X X X X X X
X _ _ _ _ _ X X X X X
X X _ X X _ X X X X X
X _ _ _ _ _ X X X X X
X S _ _ _ _ S X X X X
X X X X X X X X X X X